######
##O..#
#.@O.#
##O..#
#...>#
######