################
#.............>#
#####.##########
    #.#
    #.#
    #.#
#####.#####
#@........#
###########